{
  "id": "forest_01",
  "tileSize": 1.0,
  "layers": {
    "rows": 8,
    "cols": 10,
    "ground": [
      1,1,1,1,1,1,1,1,1,1,
      1,1,1,1,1,1,1,1,1,1,
      1,1,1,1,1,1,1,1,1,1,
      1,1,1,1,1,1,1,1,1,1,
      1,1,1,1,1,1,1,1,1,1,
      1,1,1,1,1,1,1,1,1,1,
      1,1,1,1,1,1,1,1,1,1,
      1,1,1,1,1,1,1,1,1,1
    ],
    "objects": [
      2,0,0,0,0,0,0,0,0,2,
      0,0,3,0,0,0,4,0,0,0,
      0,0,0,0,0,0,0,0,3,0,
      0,2,0,0,0,0,0,0,0,0,
      0,0,0,0,0,0,0,0,0,0,
      0,0,4,0,0,0,0,3,0,0,
      0,0,0,0,0,0,0,0,0,0,
      2,0,0,0,0,0,0,0,0,2
    ],
    "enemies": [
      0,0,0,0,0,0,0,0,0,0,
      0,0,0,0,0,0,0,0,0,0,
      0,0,0,5,0,0,0,0,0,0,
      0,0,0,0,0,0,0,6,0,0,
      0,0,5,0,0,0,0,0,0,0,
      0,0,0,0,0,0,0,0,0,0,
      0,0,0,6,0,0,5,0,0,0,
      0,0,0,0,0,0,0,0,0,0
    ]
  },
  "exits": [
    {
      "row": 3,
      "col": 9,
      "targetMapId": "forest_02",
      "targetEntranceName": "entrance_left"
    }
  ],
  "entrances": [
    {
      "name": "entrance_right",
      "row": 3,
      "col": 0
    }
  ]
}
