{
  "id": "forest_02",
  "tileSize": 1.0,
  "layers": {
    "rows": 8,
    "cols": 10,
    "ground": [
      1,1,1,1,1,1,1,1,1,1,
      1,1,1,1,1,1,1,1,1,1,
      1,1,1,1,1,1,1,1,1,1,
      1,1,1,1,1,1,1,1,1,1,
      1,1,1,1,1,1,1,1,1,1,
      1,1,1,1,1,1,1,1,1,1,
      1,1,1,1,1,1,1,1,1,1,
      1,1,1,1,1,1,1,1,1,1
    ],
    "objects": [
      2,0,0,0,0,0,0,0,0,2,
      0,3,0,0,0,0,0,4,0,0,
      0,0,0,0,3,0,0,0,0,2,
      0,0,0,0,0,0,0,0,0,0,
      0,4,0,0,0,0,0,0,0,0,
      0,0,0,3,0,0,4,0,0,0,
      0,0,0,0,0,0,0,0,3,0,
      2,0,0,0,0,0,0,0,0,2
    ],
    "enemies": [
      0,0,0,0,0,0,0,0,0,0,
      0,0,0,6,0,0,0,0,0,0,
      0,0,0,0,0,0,0,0,0,0,
      0,0,6,0,0,0,0,6,0,0,
      0,0,0,0,0,5,0,0,0,0,
      0,5,0,0,0,0,0,0,0,0,
      0,0,0,0,5,0,0,6,0,0,
      0,0,0,0,0,0,0,0,0,0
    ]
  },
  "exits": [
    {
      "row": 3,
      "col": 0,
      "targetMapId": "forest_01",
      "targetEntranceName": "entrance_right"
    }
  ],
  "entrances": [
    {
      "name": "entrance_left",
      "row": 3,
      "col": 9
    }
  ]
}
